######
#...E#
#.##.#
#.#..#
#.#.##
S....#