##########
#........E
#.######.#
#.#....#.#
#.#.##.#.#
#...##.#.#
###.##.#.#
#....#...#
#.#######.
S........#