###############
#.............E
#.###########.#
#.#.........#.#
#.#.#######.#.#
#.#.#.....#.#.#
#.#.#.###.#.#.#
#...#.#.#.#...#
###.#.#.#.###.#
#...#.#.#.....#
#.#.#.#.#####.#
#.#.#.#.....#.#
#.#.#######.#.#
#.............#
S.#############